{
  "id": "maze-01",
  "name": "Simple Maze Challenge",
  "width": 15,
  "height": 12,
  "tileset": "default",
  "layers": {
    "background": [
      [1, 1, 1, 1, 1, 1, 1, 1, 1, 1, 1, 1, 1, 1, 1],
      [1, 0, 0, 1, 0, 0, 0, 1, 0, 0, 0, 1, 0, 0, 1],
      [1, 0, 0, 1, 0, 1, 0, 1, 0, 1, 0, 1, 0, 1, 1],
      [1, 0, 0, 0, 0, 1, 0, 0, 0, 1, 0, 0, 0, 0, 1],
      [1, 1, 1, 1, 0, 1, 1, 1, 0, 1, 0, 1, 1, 0, 1],
      [1, 0, 0, 0, 0, 0, 0, 0, 0, 1, 0, 0, 0, 0, 1],
      [1, 0, 1, 1, 1, 1, 1, 1, 0, 1, 1, 1, 1, 0, 1],
      [1, 0, 0, 0, 0, 0, 0, 0, 0, 0, 0, 0, 0, 0, 1],
      [1, 1, 1, 0, 1, 1, 1, 0, 1, 1, 1, 0, 1, 1, 1],
      [1, 0, 0, 0, 0, 0, 0, 0, 0, 0, 0, 0, 0, 0, 1],
      [1, 0, 1, 1, 1, 1, 1, 1, 1, 1, 1, 1, 1, 0, 1],
      [1, 1, 1, 1, 1, 1, 1, 1, 1, 1, 1, 1, 1, 1, 1]
    ],
    "ground": [
      [0, 0, 0, 0, 0, 0, 0, 0, 0, 0, 0, 0, 0, 0, 0],
      [0, 0, 0, 0, 0, 0, 0, 0, 0, 0, 0, 0, 0, 0, 0],
      [0, 0, 0, 0, 0, 0, 0, 0, 0, 0, 0, 0, 0, 0, 0],
      [0, 0, 0, 0, 0, 0, 0, 0, 0, 0, 0, 0, 0, 0, 0],
      [0, 0, 0, 0, 0, 0, 0, 0, 0, 0, 0, 0, 0, 0, 0],
      [0, 0, 0, 0, 0, 0, 0, 0, 0, 0, 0, 0, 0, 0, 0],
      [0, 0, 0, 0, 0, 0, 0, 0, 0, 0, 0, 0, 0, 0, 0],
      [0, 0, 0, 0, 0, 0, 0, 0, 0, 0, 0, 0, 0, 0, 0],
      [0, 0, 0, 0, 0, 0, 0, 0, 0, 0, 0, 0, 0, 0, 0],
      [0, 0, 0, 0, 0, 0, 0, 0, 0, 0, 0, 0, 0, 0, 0],
      [0, 0, 0, 0, 0, 0, 0, 0, 0, 0, 0, 0, 0, 0, 0],
      [0, 0, 0, 0, 0, 0, 0, 0, 0, 0, 0, 0, 0, 0, 0]
    ],
    "foreground": [
      [0, 0, 0, 0, 0, 0, 0, 0, 0, 0, 0, 0, 0, 0, 0],
      [0, 0, 0, 0, 0, 0, 0, 0, 0, 0, 0, 0, 0, 0, 0],
      [0, 0, 0, 0, 0, 0, 0, 0, 0, 0, 0, 0, 0, 0, 0],
      [0, 0, 0, 0, 0, 0, 0, 0, 0, 0, 0, 0, 0, 0, 0],
      [0, 0, 0, 0, 0, 0, 0, 0, 0, 0, 0, 0, 0, 0, 0],
      [0, 0, 0, 0, 0, 0, 0, 0, 0, 0, 0, 0, 0, 0, 0],
      [0, 0, 0, 0, 0, 0, 0, 0, 0, 0, 0, 0, 0, 0, 0],
      [0, 0, 0, 0, 0, 0, 0, 0, 0, 0, 0, 0, 0, 0, 0],
      [0, 0, 0, 0, 0, 0, 0, 0, 0, 0, 0, 0, 0, 0, 0],
      [0, 0, 0, 0, 0, 0, 0, 0, 0, 0, 0, 0, 0, 0, 0],
      [0, 0, 0, 0, 0, 0, 0, 0, 0, 0, 0, 0, 0, 0, 0],
      [0, 0, 0, 0, 0, 0, 0, 0, 0, 0, 0, 0, 0, 0, 0]
    ],
    "collision": [
      [1, 1, 1, 1, 1, 1, 1, 1, 1, 1, 1, 1, 1, 1, 1],
      [1, 0, 0, 1, 0, 0, 0, 1, 0, 0, 0, 1, 0, 0, 1],
      [1, 0, 0, 1, 0, 1, 0, 1, 0, 1, 0, 1, 0, 1, 1],
      [1, 0, 0, 0, 0, 1, 0, 0, 0, 1, 0, 0, 0, 0, 1],
      [1, 1, 1, 1, 0, 1, 1, 1, 0, 1, 0, 1, 1, 0, 1],
      [1, 0, 0, 0, 0, 0, 0, 0, 0, 1, 0, 0, 0, 0, 1],
      [1, 0, 1, 1, 1, 1, 1, 1, 0, 1, 1, 1, 1, 0, 1],
      [1, 0, 0, 0, 0, 0, 0, 0, 0, 0, 0, 0, 0, 0, 1],
      [1, 1, 1, 0, 1, 1, 1, 0, 1, 1, 1, 0, 1, 1, 1],
      [1, 0, 0, 0, 0, 0, 0, 0, 0, 0, 0, 0, 0, 0, 1],
      [1, 0, 1, 1, 1, 1, 1, 1, 1, 1, 1, 1, 1, 0, 1],
      [1, 1, 1, 1, 1, 1, 1, 1, 1, 1, 1, 1, 1, 1, 1]
    ]
  },
  "startPosition": {
    "row": 1,
    "col": 1
  },
  "goalPosition": {
    "row": 10,
    "col": 13
  },
  "metadata": {
    "difficulty": "medium",
    "description": "Navigate through a maze using BFS or DFS algorithms",
    "targetAlgorithm": "BFS",
    "estimatedSteps": 45
  }
}
